1,1,400,0,100,0,10,,,,
1,1,0,0,400,0,10,,,,
1,1,0,0,300,0,10,,,,
1,1,500,0,300,0,10,,,,
2,1,0,0,0,0,0,0,100,1,100
